20 5 10
6 10
P-+...+--+
|.X...|..|
|.|...P..|
P.|...FP-+
|.|......|
+-P------+