20 5 10
7 10
P-+...+--+
|.X...|..|
|.|...P..|
P.|...FP-+
|.|......|
+-P------+