15 5 100
10 12
...+..+....F
.X.|..+-P-+|
.P-+--|...|.
.....+|...|.
....+-+...|.
....|...+-P.
....+P..|...
......|.|...
....+-+-+...
....P.....+.